NO assets/textures/simonkraft/netherrack_01.xpm
EA assets/textures/simonkraft/netherrack_01.xpm
WE assets/textures/simonkraft/netherrack_01.xpm
SO assets/textures/simonkraft/netherrack_01.xpm

D assets/textures/wolfenstein/wood.xpm

F assets/textures/wolfenstein/blue_stone.xpm
C       assets/textures/wolfenstein/blue_stone.xpm

111111111111111111111
101000001000000000001
10101010D011111110001
100010100010000010001
111110101111101011101
100000101000101000001
1011111010D1101111111
101000001010100000101
101011111010111110101
1010100010D0D00010101
101110101010101010101
100000101010001010001
111111101011111011101
100000101000100010001
101110101110101110111
101000100000100010101
101011111111111010101
1000D0000000000010001
101010111011111111101
1N1000001000000000001
111111111111111111111

